Alors:
numStages :nombre de fois que la fusée change de diametre (donc le nez, le bout du nozecone, le début du boat tail, la fin du boattail)
stageDiameters: les diametres des 4 éléments nommé au dessus
stagePositions  :la distance entre chaque élément nommé au dessus
numFins : nombre d'ailerons
finRootPosition : distance début aileron-nez de la fusée
finSpan : hauteur des ailerons (donc pas selon l'axe z) autrement dit longueur bout des ailerons-corps de la fusée
finRootChord : longueur des ailerons au niveau de la fusée
finTipChord longueur des ailerons au bout des ailerons
finSweepDistance : distance entre le début de ct et cr selon l'axe z
finThickness : epaisseur des ailerons (j'ai un shépa si jamais si c'est pas clair pour les ailerons)
numLaunchLugs : nombre de lunch lugs
lugSurfaceArea : surface de référence d'un lunch lugs
emptyMass : masse de la fusée sans moteur
emptyInertia : inertie selon l'axe x et y de la fusée sans moteur
emptyCenterOfMass : centre de masse de la fusée sans moteur
airbrakePosition : distance airbrakes-nez de la fusée
numAirbrakes : nomre d'airbrakes
airbrakeAngle : angle de déploiement des airbrakes
payloadMass : masse de la payload ( il faut quand meme conter la payload dans emptyMass)
mainParachuteDragArea: surface de référence du main parachute *coef de frottement
drogueParachuteDragArea surface de référence du drogue parachute*coef de frottement
mainParachuteDeploymentAltitude: altitude à laquelle se déploie le main parachute
motorId : nom du moteur (cf caracteristiques du moteur)
motorThrustFactor :facteur multiplicatif de la thrust du moteur (souvent 1)
coneMode on (pas important)
centerOfPressureFactor :facteur multipicatif sur le centre de pression (souvant 1)
normalForceCoefficientFactor :facteur multiplicatif sur la force normal(souvant 1)
dragCoefficientFactor : facteur multiplicatif sur la force de drag (souvant 1)
Voila :slightly_smiling_face:
N'hésite pas si quelque chose n'est pas clair (edited) 